Sno,ValueDate,TransactionDate,ChequeNumber,TransactionRemarks,WithdrawalAmount,DepositAmount,Balance
1,13-07-2019,15-07-2019,-,UPI/919410941037/NA/q18489499@ybl/                ,1000,0,30844.18
2,13-07-2019,15-07-2019,-,IPS/MANESH PHAR/201907131104/000000001602/CHENNAI ,705,0,30139.18
3,17-07-2019,17-07-2019,-,VIN/INERGLOBE A/201907171127/919805963327/        ,350,0,29789.18
4,17-07-2019,17-07-2019,-,ATM/SACWF854/CASH WDL/17-07-19                    ,900,0,28889.18
5,23-07-2019,23-07-2019,-,ATM/SACWF854/CASH WDL/23-07-19                    ,200,0,28689.18
6,23-07-2019,23-07-2019,-,VPS/S M CATERER/201907231237/920407017218/CHENNAI ,110,0,28579.18
7,25-07-2019,25-07-2019,-,VPS/S M CATERER/201907251145/920606030900/CHENNAI ,190,0,28389.18
8,25-07-2019,25-07-2019,-,VPS/SAMS KITCHE/201907251213/920606786398/CHENNAI ,215,0,28174.18
9,25-07-2019,25-07-2019,-,IIN/ZOMATO MEDI/201907251305/920607762671/        ,480,0,27694.18
10,26-07-2019,26-07-2019,-,VIN/BOOKMYSHOW /201907261007/920704459524/        ,194.34,0,27499.84
11,26-07-2019,26-07-2019,-,BIL/INFT/001761065682/NA/                         ,0,5000,32499.84
12,26-07-2019,26-07-2019,-,VIN/WWW PAYUBIZ/201907261655/920711215166/        ,430,0,32069.84
13,26-07-2019,26-07-2019,-,VPS/MC DONALDS /201907262009/920714473753/KANCHIPU,134,0,31935.84
14,26-07-2019,26-07-2019,-,VIN/BOOKMYSHOW /201907262144/920716574150/        ,97.17,0,31838.67
15,27-07-2019,29-07-2019,-,NFS/S1NS1812/CASH WDL/27-07-19                    ,500,0,31338.67
16,27-07-2019,29-07-2019,-,VPS/WOW MOMO   /201907271414/920808735383/CHENNAI ,152.24,0,31186.43
17,27-07-2019,29-07-2019,-,VPS/PIZZA HUT S/201907271546/920810046728/CHENNAI ,886,0,30300.43
18,27-07-2019,29-07-2019,-,VPS/JAZZ CINEMA/201907271706/920811833496/CHENNAI ,80,0,30220.43
19,28-07-2019,29-07-2019,-,VPS/SUBWAY     /201907281924/920913449967/KANCHIPU,205,0,30015.43
20,30-07-2019,30-07-2019,-,VPS/TAJ CANTEEN/201907301622/921110107386/CHENNAI ,90,0,29925.43
21,31-07-2019,31-07-2019,-,VPS/SRMIST HOST/201907311001/921204038338/CHENNAI ,5060,0,24865.43
22,31-07-2019,31-07-2019,-,UPI/921216045181/NA/q39922218@ybl/                ,50,0,24815.43
23,01-08-2019,01-08-2019,-,UPI/921310354925/NA/q28181322@ybl/                ,10,0,24805.43
24,01-08-2019,01-08-2019,-,VPS/TAJ CANTEEN/201908011210/921306090307/CHENNAI ,140,0,24665.43
25,02-08-2019,02-08-2019,-,UPI/921417353937/NA/q43861083@ybl/                ,80,0,24585.43
26,02-08-2019,02-08-2019,-,BIL/INFT/001767066835/NA/                         ,0,21000,45585.43
27,02-08-2019,02-08-2019,-,TRF TO FD no. 418413000850                        ,20000,0,25585.43
28,02-08-2019,02-08-2019,-,TRF TO FD no. 418413000851                        ,20000,0,5585.43
29,03-08-2019,03-08-2019,-,VPS/S M CATERER/201908031946/921514077250/CHENNAI ,167,0,5418.43
30,03-08-2019,03-08-2019,-,ATM/SACWF854/CASH WDL/03-08-19                    ,500,0,4918.43
31,04-08-2019,05-08-2019,-,UPI/921618128885/Oid8915263252ON/paytm@icici/ICICI,100,0,4818.43
32,04-08-2019,05-08-2019,-,IIN/ZOMATO MEDI/201908041919/921613493593/        ,602.05,0,4216.38
33,06-08-2019,06-08-2019,-,VPS/TAJ CANTEEN/201908062108/921815140450/CHENNAI ,170,0,4046.38
34,08-08-2019,08-08-2019,-,ATM/SACWF854/CASH WDL/08-08-19                    ,400,0,3646.38
35,08-08-2019,08-08-2019,-,VPS/3SIXTY5    /201908082250/922053624265/CHENNAI ,400,0,3246.38
36,08-08-2019,08-08-2019,-,VPS/INTL FC CUR/201908082255/922017884954/CHENNAI ,895,0,2351.38
37,08-08-2019,08-08-2019,-,VPS/PHD        /201908082311/922017887539/CHENNAI ,240,0,2111.38
38,10-08-2019,12-08-2019,-,IIN/ZOMATO MEDI/201908102044/922215554741/        ,586,0,1525.38
39,13-08-2019,13-08-2019,-,IIN/ZOMATO MEDI/201908131223/922506134199/        ,371,0,1154.38
40,13-08-2019,13-08-2019,-,VIN/INERGLOBE A/201908131338/922508495641/        ,200,0,954.38
41,15-08-2019,16-08-2019,-,VPS/PRIYANKA WA/201908152004/922714480418/GURGAON ,350,0,604.38
42,16-08-2019,16-08-2019,-,VPS/CONNAUGHT P/201908170126/922819421467/GURGAON ,195.32,0,409.06
43,17-08-2019,17-08-2019,-,IIN/PAYTM      /201908172127/922915726555/        ,300,0,109.06
44,18-08-2019,19-08-2019,-,BIL/INFT/001778742676/Quick Pay FT/418401503466   ,0,3000,3109.06
45,19-08-2019,19-08-2019,-,VPS/KRISPY KREM/201908190045/923019003469/CHENNAI ,130,0,2979.06
46,19-08-2019,19-08-2019,-,VIN/AY5SPT356  /201908191922/923113606505/        ,59,0,2920.06
47,20-08-2019,20-08-2019,-,UPI/923216935706/NA/q28847431@ybl/                ,32,0,2888.06
48,21-08-2019,21-08-2019,-,IIN/ZOMATO MEDI/201908211945/923314192959/        ,138,0,2750.06
49,22-08-2019,22-08-2019,-,VPS/AMAZON SELL/201908221700/923411536751/BANGALOR,1041,0,1709.06
50,22-08-2019,22-08-2019,-,VPS/CHAI KINGS /201908221706/923411539366/CHENNAI ,30,0,1679.06
51,23-08-2019,23-08-2019,-,VPS/SUBWAY     /201908231525/923509949056/KANCHIPU,205,0,1474.06
52,25-08-2019,26-08-2019,-,VIN/PAYTM      /201908252147/923716378190/        ,150,0,1324.06
53,26-08-2019,26-08-2019,-,IPS/WOW ROLLS S/201908261629/000000006928/CHENNAI ,200,0,1124.06
54,26-08-2019,26-08-2019,-,BIL/INFT/001784344452/NA/                         ,0,5000,6124.06
55,27-08-2019,27-08-2019,-,UPI/923916883214/NA/q28181322,60,0,6064.06
56,28-08-2019,28-08-2019,-,VPS/TAJ CANTEEN/201908281143/924006025778/CHENNAI ,90,0,5974.06
57,28-08-2019,28-08-2019,-,IPS/WOW ROLLS S/201908281701/000000006988/CHENNAI ,100,0,5874.06
58,29-08-2019,29-08-2019,-,UPI/924109863936/NA/q28847431@ybl/                ,42,0,5832.06
59,30-08-2019,30-08-2019,-,NFS/00824012/CASH WDL/30-08-19                    ,300,0,5532.06
60,30-08-2019,30-08-2019,-,VPS/MY CAKE VAL/201908310131/924220193639/KANCHIPU,160,0,5372.06
61,31-08-2019,31-08-2019,-,POSDEC CHG/17-08-2019/1685+GST                    ,29.5,0,5342.56
62,01-09-2019,02-09-2019,-,UPI/924413546549/NA/q34896424@ybl/                ,209,0,5133.56
63,01-09-2019,02-09-2019,-,UPI/924414918245/NA/q34896424@ybl/                ,30,0,5103.56
64,02-09-2019,02-09-2019,-,UPI/924511396062/NA/q34896424@ybl/                ,80,0,5023.56
65,02-09-2019,02-09-2019,-,UPI/924516361305/NA/q39922218@ybl/                ,60,0,4963.56
66,02-09-2019,02-09-2019,-,IIN/PAYTM      /201909022302/924517507587/        ,80,0,4883.56
67,03-09-2019,03-09-2019,-,UPI/924610761101/NA/q28847431@ybl/                ,20,0,4863.56
68,03-09-2019,03-09-2019,-,VPS/QUEENS COUR/201909031233/924607008321/CHENNAI ,170,0,4693.56
69,03-09-2019,03-09-2019,-,UPI/924612340670/NA/q02486094@ybl/                ,50,0,4643.56
70,03-09-2019,03-09-2019,-,UPI/924618884426/NA/q05300606@ybl/                ,1200,0,3443.56
71,04-09-2019,04-09-2019,-,POSDEC CHG/17-08-2019/1685+GST                    ,29.5,0,3414.06
72,04-09-2019,04-09-2019,-,UPI/924716118460/NA/q28847431@ybl/                ,20,0,3394.06
73,04-09-2019,04-09-2019,-,UPI/924722728721/You are paying/amazon@apl/Axis Ba,699,0,2695.06
74,05-09-2019,05-09-2019,-,VPS/S M CATERER/201909051431/924809003514/CHENNAI ,330,0,2365.06
75,06-09-2019,06-09-2019,-,UPI/924910968806/NA/q28847431@ybl/                ,12,0,2353.06
76,06-09-2019,06-09-2019,-,UPI/924944192209/Oid701556212UPI/dominospizzaonl/P,714,0,1639.06
77,08-09-2019,09-09-2019,-,VPS/BIG SAVE SU/201909082046/925115053901/KANCHIPU,389,0,1250.06
78,09-09-2019,09-09-2019,-,UPI/925212231773/NA/q28847431@ybl/                ,50,0,1200.06
79,09-09-2019,09-09-2019,-,UPI/925212242529/NA/q28847431@ybl/                ,50,0,1150.06
80,09-09-2019,09-09-2019,-,UPI/RVSL925212231773/NA/q28847431@ybl/            ,0,50,1200.06
81,09-09-2019,09-09-2019,-,UPI/925212264703/NA/q28847431@ybl/                ,30,0,1170.06
82,10-09-2019,10-09-2019,-,UPI/925310937508/NA/q28847431@ybl/                ,35,0,1135.06
83,10-09-2019,10-09-2019,-,VPS/TAJ CANTEEN/201909101246/925307036736/CHENNAI ,130,0,1005.06
84,11-09-2019,11-09-2019,-,NFS/00824012/CASH WDL/11-09-19                    ,500,0,505.06
85,11-09-2019,11-09-2019,-,VPS/MSW GRAND G/201909111941/925414146929/Kanchipu,236,0,269.06
86,12-09-2019,12-09-2019,-,Reg Dcard fee refund                              ,0,177,446.06
87,13-09-2019,13-09-2019,-,UPI/925614756132/NA/q28847431@ybl/                ,12,0,434.06
88,13-09-2019,13-09-2019,-,BIL/INFT/001799252562/                            ,0,3000,3434.06
89,13-09-2019,13-09-2019,-,NFS/00824017/CASH WDL/13-09-19                    ,1300,0,2134.06
90,13-09-2019,13-09-2019,-,UPI/925620576849/Collect/townscript.payu/HDFC BANK,204.7,0,1929.36
91,15-09-2019,16-09-2019,-,IIN/ZOMATO MEDI/201909152001/925814945665/        ,174,0,1755.36
92,16-09-2019,16-09-2019,-,ATM/SACWF854/CASH WDL/16-09-19                    ,300,0,1455.36
93,18-09-2019,18-09-2019,-,UPI/926114415846/NO REMARKS/chakri.v@icici/ICICI B,1,0,1454.36
94,18-09-2019,18-09-2019,-,UPI/926142919002/Payment from Ph/Chakri.v@icici/IC,99,0,1355.36
95,18-09-2019,18-09-2019,-,UPI/926132876470/Payment from Ph/Q28847431@ybl/Cit,40,0,1315.36
96,18-09-2019,18-09-2019,-,UPI/926148016563/Payment made to/o331276a@mairte/A,100,0,1215.36
97,19-09-2019,19-09-2019,-,UPI/926224970668/Payment from Ph/chakri.v@icici/IC,40,0,1175.36
98,19-09-2019,19-09-2019,-,UPI/926245807891/Payment from Ph/Q28847431@ybl/Cit,12,0,1163.36
99,19-09-2019,19-09-2019,-,VPS/PRINCESS CO/201909192005/926214101006/CHENNAI ,105,0,1058.36
100,20-09-2019,20-09-2019,-,UPI/926300014058/Collect/townscript.payu/HDFC BANK,307.04,0,751.32
101,20-09-2019,20-09-2019,-,UPI/926300007753/Collect/townscript.payu/HDFC BANK,307.04,0,444.28
102,20-09-2019,20-09-2019,-,UPI/926311720560/NO REMARKS/Q28847431@ybl/City Uni,50,0,394.28
103,20-09-2019,20-09-2019,-,UPI/926315889735/NO REMARKS/Q28847431@ybl/City Uni,30,0,364.28
104,20-09-2019,20-09-2019,-,UPI/926315899855/NO REMARKS/Q28847431@ybl/City Uni,44,0,320.28
105,20-09-2019,20-09-2019,-,VPS/S M CATERER/201909201547/926310029962/CHENNAI ,220,0,100.28
106,22-09-2019,23-09-2019,-,VPS/ST155 TRINE/201909222052/926515511893/CHENNAI ,2000,0,-1899.72
107,22-09-2019,23-09-2019,-,BIL/INFT/001805246430/NA/                         ,0,4000,2100.28
108,23-09-2019,23-09-2019,-,UPI/926618909606/Payment made to/o718215b@mairte/A,40,0,2060.28
109,23-09-2019,23-09-2019,-,UPI/926618914124/Payment made to/o718215b@mairte/A,10,0,2050.28
110,23-09-2019,23-09-2019,-,UPI/926618180230/UPI/rohithraveena00/City Union Ba,25,0,2025.28
111,23-09-2019,23-09-2019,-,UPI/926618929720/UPI/goog-payment@ok/Axis Bank Ltd,0,21,2046.28
112,24-09-2019,24-09-2019,-,UPI/926733913691/NA/Saksham Srm Cse/Paytm Payments,10,0,2036.28
113,24-09-2019,24-09-2019,-,UPI/926733961018/Oid201909240958/paytm-40275929@/P,10,0,2026.28
114,24-09-2019,24-09-2019,-,NFS/DECN2559/CASH WDL/24-09-19                    ,300,0,1726.28
115,25-09-2019,25-09-2019,-,UPI/926833306909/Oid201909250939/paytm-40789937@/P,12,0,1714.28
116,25-09-2019,25-09-2019,-,VPS/MSW BIG SAV/201909252148/926816224343/Kanchipu,67,0,1647.28
117,25-09-2019,25-09-2019,-,BIL/INFT/001807448873/NA/                         ,0,5000,6647.28
118,26-09-2019,26-09-2019,-,UPI/926944585579/Oid201909262040/pay9940508458@p/P,30,0,6617.28
119,26-09-2019,26-09-2019,-,UPI/926944624849/NA/Chakravarti Vis/Paytm Payments,150,0,6467.28
120,27-09-2019,27-09-2019,-,VPS/SAI SARVESH/201909271524/927009541889/CHENNAI ,120,0,6347.28
121,27-09-2019,27-09-2019,-,UPI/927017155959/UPI/ganeshpalanivel/Indian Overse,20,0,6327.28
122,27-09-2019,27-09-2019,-,VPS/ANDA PAV   /201909272114/927015767340/CHENNAI ,170,0,6157.28
123,28-09-2019,30-09-2019,-,NFS/CUBFI453/CASH WDL/28-09-19                    ,300,0,5857.28
124,28-09-2019,30-09-2019,-,UPI/927113580717/Udhaari/duhananant@oksb/State Ban,0,75,5932.28
125,28-09-2019,30-09-2019,-,UPI/927117138711/Payment made to/o331289a@mairte/A,95,0,5837.28
126,28-09-2019,30-09-2019,-,UPI/927144873738/NA/8124580060@payt/Lakshmi Vilas ,150,0,5687.28
127,29-09-2019,30-09-2019,-,UPI/927240437448/NA/AMZN0000989852@/Bandhan Bank  ,120,0,5567.28
128,29-09-2019,30-09-2019,-,UPI/927219070795/UPI/realaditya2312@/South Indian ,200,0,5367.28
129,29-09-2019,30-09-2019,-,UPI/927219903701/UPI/goog-payment@ok/Axis Bank Ltd,0,10,5377.28
130,29-09-2019,30-09-2019,-,UPI/927244205182/NA/8124580060@payt/Lakshmi Vilas ,300,0,5077.28
131,29-09-2019,30-09-2019,-,UPI/927244310203/NA/Q62096634@ybl/State Bank Of I ,85,0,4992.28
132,29-09-2019,30-09-2019,-,UPI/927245422170/Oid201909292109/paytm-38583141@/P,40,0,4952.28
133,29-09-2019,30-09-2019,-,UPI/927245436487/Oid201909292111/paytm-38583141@/P,40,0,4912.28
134,29-09-2019,30-09-2019,-,418401503466:Int.Pd:29-06-2019 to 29-09-2019      ,0,116,5028.28
135,30-09-2019,30-09-2019,-,UPI/927341642946/Payment made to/o718215b@mairte/A,10,0,5018.28
136,30-09-2019,30-09-2019,-,UPI/927345923674/Payment made to/o718215b@mairte/A,70,0,4948.28
137,30-09-2019,30-09-2019,-,UPI/927345097849/Payment made to/o718215b@mairte/A,40,0,4908.28
138,01-10-2019,01-10-2019,-,UPI/927433526192/NA/Q34896424@ybl/Vijaya Bank     ,80,0,4828.28
139,01-10-2019,01-10-2019,-,UPI/927439170179/NA/Q28847431@ybl/City Union Bank ,18,0,4810.28
140,01-10-2019,01-10-2019,-,UPI/927417337982/NA/chakri.v@icici/ICICI Bank     ,100,0,4710.28
141,02-10-2019,03-10-2019,-,UPI/927536773017/Oid201910021222/pay7708039407@p/P,45,0,4665.28
142,02-10-2019,03-10-2019,-,UPI/927536798562/Oid201910021225/pay7708039407@p/P,10,0,4655.28
143,02-10-2019,03-10-2019,-,VPS/CHENNAI MET/201910021954/927514340897/CHENNAI ,200,0,4455.28
144,02-10-2019,03-10-2019,-,VPS/SPI PALAZZO/201910021552/927510157528/CHENNAI ,120,0,4335.28
145,02-10-2019,03-10-2019,-,IPS/TACO BELL  /201910021901/000000020692/CHENNAI ,229,0,4106.28
146,02-10-2019,03-10-2019,-,VPS/CHENNAI MET/201910021946/927514062120/CHENNAI ,252,0,3854.28
147,03-10-2019,03-10-2019,-,UPI/927639838296/Oid201910031518/paytm-9326077@p/P,50,0,3804.28
148,03-10-2019,03-10-2019,-,UPI/927644089042/NA/Q49465703@ybl/Axis Bank Ltd.  ,30,0,3774.28
149,04-10-2019,04-10-2019,-,UPI/927738051362/Oid201910041426/paytm-40887451@/P,22,0,3752.28
150,04-10-2019,04-10-2019,-,UPI/927718876453/UPI/8460706112@apl/ICICI Bank    ,0,2,3754.28
151,04-10-2019,04-10-2019,-,UPI/927718539010/UPI/8460706112@apl/ICICI Bank    ,0,118,3872.28
152,04-10-2019,04-10-2019,-,VPS/ROCK N ROLL/201910041920/927713358210/CHENNAI ,540,0,3332.28
153,05-10-2019,05-10-2019,-,UPI/927817242774/Bill Payment/chakri.v@icici/ICICI,0,100,3432.28
154,05-10-2019,05-10-2019,-,UPI/927844218708/NA/AMZN0001429017@/Federal Bank  ,35,0,3397.28
155,05-10-2019,05-10-2019,-,UPI/927844242588/Oid201910052042/pay9790847609@p/P,25,0,3372.28
156,06-10-2019,07-10-2019,-,VIN/Bigtree Ent/201910061302/927918416094/        ,977.28,0,2395
157,06-10-2019,07-10-2019,-,UPI/927937175637/NA/Q70042386@ybl/Yes Bank Ltd    ,40,0,2355
158,06-10-2019,07-10-2019,-,UPI/927943623124/NA/Q70042386@ybl/Yes Bank Ltd    ,30,0,2325
159,06-10-2019,07-10-2019,-,UPI/927943687514/NA/Q34896424@ybl/Vijaya Bank     ,10,0,2315
160,06-10-2019,07-10-2019,-,IIN/ZOMATO MEDI/201910062012/927914849117/        ,143,0,2172
161,08-10-2019,08-10-2019,-,UPI/928139277534/NA/Q28847431,30,0,2142
162,10-10-2019,10-10-2019,-,UPI/928339652445/NA/Q28847431@ybl/City Union Bank ,20,0,2122
163,10-10-2019,10-10-2019,-,UPI/928344323608/NA/Q34896424@ybl/Vijaya Bank     ,60,0,2062
164,11-10-2019,11-10-2019,-,UPI/928435943466/NA/Q49465703@ybl/Axis Bank Ltd.  ,42,0,2020
165,11-10-2019,11-10-2019,-,UPI/928444652345/NA/Q34896424@ybl/Vijaya Bank     ,88,0,1932
166,12-10-2019,14-10-2019,-,ATM/SACWF854/CASH WDL/12-10-19                    ,200,0,1732
167,12-10-2019,14-10-2019,-,UPI/928537499269/Oid201910121326/paytm-14781806@/P,10,0,1722
168,12-10-2019,14-10-2019,-,UPI/928542209009/Oid201910121810/pay9790847609@p/P,30,0,1692
169,12-10-2019,14-10-2019,-,UPI/928542284909/Oid201910121816/pay9790847609@p/P,70,0,1622
170,13-10-2019,14-10-2019,-,IIN/Zomato     /201910131927/928613988317/        ,717,0,905
171,14-10-2019,14-10-2019,-,UPI/928741113238/NA/Q34896424@ybl/Vijaya Bank     ,40,0,865
172,14-10-2019,14-10-2019,-,UPI/928741350770/NA/Q49465703@ybl/Axis Bank Ltd.  ,129,0,736
173,18-10-2019,18-10-2019,-,UPI/929134853805/NA/Q28181322@ybl/City Union Bank ,10,0,726
174,18-10-2019,18-10-2019,-,UPI/929136993017/NA/9560900660@payt/South Indian B,0,1,727
175,18-10-2019,18-10-2019,-,UPI/929137801995/NA/AMZN0001429017@/Federal Bank  ,35,0,692
176,18-10-2019,18-10-2019,-,UPI/929114884006/UPI/realaditya2312@/South Indian ,0,300,992
177,18-10-2019,18-10-2019,-,UPI/929140160486/Oid201910181609/pay9940508458@p/P,30,0,962
178,18-10-2019,18-10-2019,-,UPI/929144574918/NA/Q28464092@ybl/HDFC BANK LTD   ,135,0,827
179,18-10-2019,18-10-2019,-,UPI/929144614047/NA/Q28464092@ybl/HDFC BANK LTD   ,135,0,692
180,19-10-2019,19-10-2019,-,UPI/929236562742/Payment from Ph/9262226751@ybl/IC,0,160,852
181,19-10-2019,19-10-2019,-,IIN/I-Debit/ZOMATO MEDI/201910192007/929201013024/,165,0,687
182,20-10-2019,21-10-2019,-,UPI/929318072241/NA/chakri.v@icici/ICICI Bank     ,60,0,627
183,20-10-2019,21-10-2019,-,MMT/IMPS/929318480600/External Cashba/ppbl      /P,0,20,647
184,20-10-2019,21-10-2019,-,VPS/BIG SAVE SU/201910201951/929314078844/KANCHIPU,340,0,307
185,20-10-2019,21-10-2019,-,UPI/929322465679/NA/chakri.v@icici/ICICI Bank     ,20,0,287
186,22-10-2019,22-10-2019,-,UPI/929535630050/Payment made to/r16429a@mairtel/A,30,0,257
187,22-10-2019,22-10-2019,-,UPI/929540989123/NA/Q70042386@ybl/Yes Bank Ltd    ,30,0,227
188,23-10-2019,23-10-2019,-,MABchgs-Aug19+GST                                 ,226.99,0,0.01
189,23-10-2019,23-10-2019,-,MABchgs-Sep19+GST                                 ,0.01,0,0
190,23-10-2019,23-10-2019,-,BIL/INFT/001829782459/NA/                         ,0,1000,1000
191,24-10-2019,24-10-2019,-,UPI/929743287363/NA/8989990879@payt/State Bank Of ,50,0,950
192,25-10-2019,25-10-2019,-,BIL/INFT/001830722229/NA/                         ,0,6000,6950
193,25-10-2019,25-10-2019,-,UPI/929841557618/NA/Q24380470@ybl/Axis Bank Ltd.  ,90,0,6860
194,25-10-2019,25-10-2019,-,IIN/Zomato     /201910251946/929814798469/        ,224,0,6636
195,26-10-2019,28-10-2019,-,NFS/DECN2559/CASH WDL/26-10-19                    ,300,0,6336
196,26-10-2019,28-10-2019,-,NFS/S1GP0242/CASH WDL/26-10-19                    ,1000,0,5336
197,26-10-2019,28-10-2019,-,IPS/ADYAR ANAND/201910260804/000000007546/CHENNAI ,304.5,0,5031.5
198,26-10-2019,28-10-2019,-,IPS/ADYAR ANAND/201910260812/000000001371/CHENNAI ,141.75,0,4889.75
199,27-10-2019,28-10-2019,-,IPS/MADDU YESWA/201910271212/000000000721/CHIRALA ,232,0,4657.75
200,28-10-2019,28-10-2019,-,IIN/Zomato     /201910282020/930114539255/        ,156,0,4501.75
201,29-10-2019,29-10-2019,-,BIL/INFT/001833333438/NA/                         ,0,7000,11501.75
202,29-10-2019,29-10-2019,-,VPS/THE BLACK  /201910291558/930210607150/CHENNAI ,5250,0,6251.75
203,30-10-2019,30-10-2019,-,VPS/SUBWAY     /201910301355/930308001826/KANCHIPU,150,0,6101.75
204,30-10-2019,30-10-2019,-,UPI/930339903891/Oid201910301548/paytm-41887125@/P,50,0,6051.75
205,31-10-2019,31-10-2019,-,UPI/930435279466/NA/Q70042386@ybl/Yes Bank Ltd    ,55,0,5996.75
206,31-10-2019,31-10-2019,-,UPI/930436902683/Oid201910311217/paytm-5262118@p/P,20,0,5976.75
207,31-10-2019,31-10-2019,-,UPI/930438142973/Oid201910311402/pay9940508458@p/P,30,0,5946.75
208,31-10-2019,31-10-2019,-,UPI/930415403977/NA/chakri.v@icici/ICICI Bank     ,46,0,5900.75
209,31-10-2019,31-10-2019,-,IIN/Zomato     /201910312034/930415454879/        ,200,0,5700.75
210,01-11-2019,01-11-2019,-,BIL/INFT/001835696823/Kusum Birthday /            ,0,1500,7200.75
211,01-11-2019,01-11-2019,-,UPI/930538186265/Oid201911011426/paytm-14750770@/P,80,0,7120.75
212,01-11-2019,01-11-2019,-,UPI/930538426114/Oid201911011449/paytm-41887125@/P,50,0,7070.75
213,02-11-2019,02-11-2019,-,UPI/930630093003/NA/8989990879@payt/State Bank Of ,0,100,7170.75
214,02-11-2019,02-11-2019,-,UPI/930631171820/NA/Q42594419@ybl/Axis Bank Ltd.  ,12,0,7158.75
215,02-11-2019,02-11-2019,-,VPS/DURGA Y    /201911021729/930611145951/CHENNAI ,205,0,6953.75
216,02-11-2019,02-11-2019,-,UPI/930641151064/Oid201911021736/paytm-40928083@/P,132,0,6821.75
217,02-11-2019,02-11-2019,-,UPI/930617375280/NA/chakri.v@icici/ICICI Bank     ,400,0,6421.75
218,02-11-2019,02-11-2019,-,UPI/930644682462/NA/AMZN0000258860@/Kerala Gramin ,35,0,6386.75
219,03-11-2019,04-11-2019,-,IIN/Zomato     /201911031923/930713504011/        ,156,0,6230.75
220,03-11-2019,04-11-2019,-,UPI/930745181303/NA/8989990879@payt/State Bank Of ,70,0,6160.75
221,04-11-2019,04-11-2019,-,VPS/S M CATERER/201911041503/930809062565/CHENNAI ,136,0,6024.75
222,04-11-2019,04-11-2019,-,UPI/930839499502/Oid201911041539/pay9940508458@p/P,40,0,5984.75
223,04-11-2019,05-11-2019,-,UPI/930847161418/NA/8989990879@payt/State Bank Of ,0,20,6004.75
224,05-11-2019,05-11-2019,-,UPI/930933334588/Oid201911050937/paytm-40887451@/P,40,0,5964.75
225,05-11-2019,05-11-2019,-,UPI/930944769156/NA/AMZN0001429017@/Federal Bank  ,35,0,5929.75
226,05-11-2019,05-11-2019,-,UPI/930944812064/Oid201911052041/paytm-40928083@/P,60,0,5869.75
227,06-11-2019,06-11-2019,-,UPI/931036727615/Payment made to/o718215b@mairte/A,45,0,5824.75
228,06-11-2019,06-11-2019,-,UPI/931036847855/Oid201911061215/pay9790847609@p/P,62,0,5762.75
229,06-11-2019,06-11-2019,-,UPI/931038569951/Oid201911061458/pay9940508458@p/P,40,0,5722.75
230,06-11-2019,06-11-2019,-,UPI/931040607957/NA/8989990879@payt/State Bank Of ,50,0,5672.75
231,07-11-2019,07-11-2019,-,ATM/SACWF854/CASH WDL/07-11-19                    ,2500,0,3172.75
232,07-11-2019,07-11-2019,-,UPI/931137603005/NA/8989990879@payt/State Bank Of ,60,0,3112.75
233,07-11-2019,07-11-2019,-,UPI/931137835429/NA/8989990879@payt/State Bank Of ,30,0,3082.75
234,07-11-2019,07-11-2019,-,UPI/931137954706/NA/Q83284862@ybl/State Bank Of I ,40,0,3042.75
235,08-11-2019,08-11-2019,-,NFS/00824013/CASH WDL/08-11-,2000,0,1042.75
236,09-11-2019,11-11-2019,-,VPS/TAJ MAHAL R/201911092023/931314169026/KANCHEEP,220,0,822.75
237,10-11-2019,11-11-2019,-,UPI/931444701124/Oid201911102006/paytm-40928083@/P,40,0,782.75
238,11-11-2019,11-11-2019,-,IIN/Zomato     /201911111949/931514162553/        ,155,0,627.75
239,12-11-2019,12-11-2019,-,VPS/NEW BIRIYAN/201911121324/931607125605/KANCHEEP,100,0,527.75
240,12-11-2019,12-11-2019,-,UPI/931637934766/NA/Q49465703@ybl/Axis Bank Ltd.  ,50,0,477.75
241,12-11-2019,12-11-2019,-,UPI/931641588518/Oid201911121737/pay9790847609@p/P,10,0,467.75
242,12-11-2019,12-11-2019,-,UPI/931641619905/Oid201911121739/pay9790847609@p/P,35,0,432.75
243,12-11-2019,12-11-2019,-,UPI/931644924393/NA/Q49465703@ybl/Axis Bank Ltd.  ,242,0,190.75
244,12-11-2019,12-11-2019,-,UPI/931644200768/NA/8989990879@payt/State Bank Of ,10,0,180.75
245,13-11-2019,13-11-2019,-,UPI/931742009024/NA/Q49465703@ybl/Axis Bank Ltd.  ,40,0,140.75
246,14-11-2019,14-11-2019,-,MABchgs-Oct19+GST                                 ,140.74,0,0.01
247,14-11-2019,14-11-2019,-,UPI/931833354264/Promo Cashback/upi-cashback@pa/Pa,0,20,20.01
248,14-11-2019,14-11-2019,-,IPS REF DT 11 11 2019 068633 ZOMATO MEDIA PRIVATE ,0,155,175.01
249,14-11-2019,14-11-2019,-,UPI/931818314698/Friends/chakri.v@icici/ICICI Bank,0,20,195.01
250,14-11-2019,14-11-2019,-,UPI/931818417298/Friends/chakri.v@icici/ICICI Bank,0,10,205.01
251,15-11-2019,15-11-2019,-,UPI/931919212254/NA/chakri.v@icici/ICICI Bank     ,165,0,40.01
252,21-11-2019,21-11-2019,-,UPI/932543122505/NA/8989990879@payt/State Bank Of ,40,0,0.01
253,22-11-2019,22-11-2019,-,UPI/932615798032/UPI/jhamanas6@oksbi/State Bank Of,0,60,60.01
254,22-11-2019,22-11-2019,-,UPI/932615306918/Friends/chakri.v@icici/ICICI Bank,0,1400,1460.01
255,22-11-2019,22-11-2019,-,VPS/H AND M HEN/201911221546/932610155969/chennai ,1398,0,62.01
256,22-11-2019,22-11-2019,-,UPI/932617139009/UPI/jhamanas6@oksbi/State Bank Of,25,0,37.01
257,22-11-2019,22-11-2019,-,BIL/INFT/001853221643/NA/                         ,0,2000,2037.01
258,22-11-2019,22-11-2019,-,UPI/932644663842/NA/8989990879@payt/State Bank Of ,54,0,1983.01
259,22-11-2019,22-11-2019,-,UPI/932620127223/UPI/jhamanas6@oksbi/State Bank Of,41,0,1942.01
260,23-11-2019,25-11-2019,-,UPI/932711167490/NA/chakri.v@icici/ICICI Bank     ,100,0,1842.01
261,24-11-2019,25-11-2019,-,UPI/932807242019/Friends/balagrandhi@ici/ICICI Ban,0,1000,2842.01
262,25-11-2019,25-11-2019,-,BIL/INFT/001854945603/NA/                         ,0,5000,7842.01
263,26-11-2019,26-11-2019,-,VPS/MOHD SULEMA/201911261408/933008993672/GURGAON ,290,0,7552.01
264,26-11-2019,26-11-2019,-,IIN/I-Debit/ZOMATO MEDI/201911261411/933002005228/,473.5,0,7078.51
265,27-11-2019,27-11-2019,-,IIN/I-Debit/ZOMATO MEDI/201911271004/933106002236/,241.15,0,6837.36
266,27-11-2019,27-11-2019,-,IIN/Zomato     /201911271414/933108656975/        ,222.46,0,6614.9
267,27-11-2019,27-11-2019,-,IIN/Zomato     /201911271419/933108673469/        ,248.38,0,6366.52
268,27-11-2019,27-11-2019,-,IIN/Zomato     /201911271940/933114778619/        ,1292.96,0,5073.56
269,28-11-2019,28-11-2019,-,UPI/933231178223/NA/Q11456702@ybl/State Bank Of I ,130,0,4943.56
270,28-11-2019,28-11-2019,-,IIN/I-Debit/ZOMATO MEDI/201911281408/933209004538/,594.82,0,4348.74
271,28-11-2019,28-11-2019,-,IIN/I-Debit/ZOMATO MEDI/201911282054/933206008998/,1130,0,3218.74
272,29-11-2019,29-11-2019,-,IIN/Zomato     /201911291304/933307614497/        ,406,0,2812.74
273,29-11-2019,29-11-2019,-,IIN/Zomato     /201911291312/933307643459/        ,108,0,2704.74
274,29-11-2019,29-11-2019,-,IIN/Zomato     /201911291316/933307658963/        ,289.06,0,2415.68
275,29-11-2019,29-11-2019,-,IIN/Zomato     /201911291431/933309967459/        ,108,0,2307.68
276,29-11-2019,29-11-2019,-,IIN/Zomato     /201911292050/933315672061/        ,1230.8,0,1076.88
277,30-11-2019,30-11-2019,-,BIL/INFT/001858404092/NA/                         ,0,5000,6076.88
278,30-11-2019,30-11-2019,-,IIN/Zomato     /201911301152/933406385345/        ,138.1,0,5938.78
279,30-11-2019,30-11-2019,-,VIN/ZOMATO     /201911301226/933406383686/        ,472.58,0,5466.2
280,30-11-2019,30-11-2019,-,VPS/DUNKIN     /201911302046/933415930304/GURGAON ,209,0,5257.2
281,30-11-2019,30-11-2019,-,VPS/NEW YORK SL/201911302138/933416022079/GURGAON ,565,0,4692.2
282,30-11-2019,30-11-2019,-,VPS/THEOBROMA F/201911302146/933416975775/GURGAON ,131,0,4561.2
283,30-11-2019,30-11-2019,-,VPS/DOMINOS PIZ/201911302153/933416979667/GURGAON ,104,0,4457.2
284,01-12-2019,02-12-2019,-,IIN/Zomato     /201912011044/933505213063/        ,491.04,0,3966.16
285,01-12-2019,02-12-2019,-,IIN/Zomato     /201912012025/933514436927/        ,759,0,3207.16
286,02-12-2019,02-12-2019,-,VIN/ZOMATO     /201912021410/933608622087/        ,688.6,0,2518.56
287,02-12-2019,02-12-2019,-,IIN/Zomato     /201912022108/933615746401/        ,472.9,0,2045.66
288,03-12-2019,03-12-2019,-,IIN/Zomato     /201912031210/933706350789/        ,228.5,0,1817.16
289,03-12-2019,03-12-2019,-,IIN/Zomato     /201912031418/933708779951/        ,383.26,0,1433.9
290,03-12-2019,03-12-2019,-,IIN/Zomato     /201912031859/933713674557/        ,365.8,0,1068.1
291,03-12-2019,03-12-2019,-,VPS/MOHD SULEMA/201912040242/933721114650/GURGAON ,295,0,773.1
292,04-12-2019,04-12-2019,-,VPS/MOHD SULEMA/201912041814/933812120827/GURGAON ,129,0,644.1
293,04-12-2019,04-12-2019,-,UPI/933863213605/Payment from Ph/9030600470@ybl/Ko,0,100,744.1
294,04-12-2019,04-12-2019,-,UPI/933845672357/Oid723142291UPI/dominospizzaonl/P,732,0,12.1
295,05-12-2019,05-12-2019,-,BIL/INFT/001863746013/NA/                         ,0,5000,5012.1
296,05-12-2019,05-12-2019,-,IIN/Zaak Epayme/201912051026/933904258091/        ,1,0,5011.1
297,05-12-2019,05-12-2019,-,VPS/PVR        /201912051343/933908286960/NEW DELH,966,0,4045.1
298,05-12-2019,05-12-2019,-,VPS/PVR        /201912051544/933910350086/NEW DELH,580,0,3465.1
299,05-12-2019,05-12-2019,-,VPS/CINNABON AN/201912051728/933911567036/NEW DELH,170,0,3295.1
300,05-12-2019,05-12-2019,-,VPS/CINNABON AN/201912051740/933912513707/NEW DELH,170,0,3125.1
301,05-12-2019,05-12-2019,-,IIN/Zaak Epayme/201912051755/933912735091/        ,439.16,0,2685.94
302,05-12-2019,05-12-2019,-,IIN/Zaak Epayme/201912051906/933913086075/        ,355.13,0,2330.81
303,05-12-2019,05-12-2019,-,IIN/I-Debit/ZOMATO MEDI/201912051957/933901008940/,880.7,0,1450.11
304,09-12-2019,09-12-2019,-,IPS REF DT 11 06 2019 069047 UBER INR             ,0,1,1451.11
305,09-12-2019,09-12-2019,-,VPS/TATA STARBU/201912091848/93431370,300,0,1151.11
306,09-12-2019,09-12-2019,-,IIN/Zaak Epayme/201912091945/934314218045/        ,48.34,0,1102.77
307,09-12-2019,09-12-2019,-,IIN/Zaak Epayme/201912092039/934315416853/        ,44.1,0,1058.67
308,10-12-2019,10-12-2019,-,IIN/Zaak Epayme/201912102006/934414786315/        ,57.72,0,1000.95
309,11-12-2019,11-12-2019,-,MABchgs-Nov19+GST                                 ,708,0,292.95
310,12-12-2019,12-12-2019,-,IIN/Zomato     /201912121754/934612609371/        ,208,0,84.95
311,20-12-2019,20-12-2019,-,BIL/INFT/001875562582/NA/                         ,0,2000,2084.95
312,20-12-2019,20-12-2019,-,IIN/Zaak Epayme/201912202105/935415140653/        ,86.08,0,1998.87
313,22-12-2019,23-12-2019,-,VPS/PVR LIMITED/201912221255/935607205861/GURGAON ,345,0,1653.87
314,24-12-2019,24-12-2019,-,VPS/CALIFORNIA /201912241152/935806306317/GURGAON ,89,0,1564.87
315,24-12-2019,24-12-2019,-,VPS/BURGER KING/201912241438/935809510542/GURGAON ,47.26,0,1517.61
316,25-12-2019,26-12-2019,-,UPI/935942796289/NA/Q11456702@ybl/State Bank Of I ,100,0,1417.61
317,26-12-2019,26-12-2019,-,VPS/SUGARLICOUS/201912261800/936012758578/GURGAON ,651,0,766.61
318,26-12-2019,26-12-2019,-,VIN/UBER       /201912261914/936013834622/        ,76.02,0,690.59
319,27-12-2019,27-12-2019,-,VPS/CHAAYOS    /201912271427/936108331456/GURGAON ,139,0,551.59
320,27-12-2019,27-12-2019,-,VPS/CHAAYOS    /201912271451/936109351154/GURGAON ,139,0,412.59
321,27-12-2019,27-12-2019,-,VPS/CALIFORNIA /201912271846/936113555104/GURGAON ,178,0,234.59
322,27-12-2019,27-12-2019,-,VPS/CALIFORNIA /201912271857/936113567126/GURGAON ,75,0,159.59
323,30-12-2019,31-12-2019,-,418401503466:Int.Pd:30-09-2019 to 30-12-2019      ,0,18,177.59
324,31-12-2019,31-12-2019,-,IIN/Zaak Epayme/201912311608/936510003575/        ,93.78,0,83.81
325,03-01-2020,03-01-2020,-,BIL/INFT/001886554633/                            ,0,5000,5083.81
326,03-01-2020,03-01-2020,-,BIL/INFT/001886556263/int charges/                ,0,500,5583.81
327,05-01-2020,06-01-2020,-,418413000850: Closure Proceeds                    ,0,20428,26011.81
328,05-01-2020,06-01-2020,-,418413000851: Closure Proceeds                    ,0,20428,46439.81
329,05-01-2020,06-01-2020,-,TRF TO FD no. 418413001218                        ,15000,0,31439.81
330,07-01-2020,07-01-2020,-,UPI/000713693606/Oid202001071305/pay9940508458@p/P,40,0,31399.81
331,07-01-2020,07-01-2020,-,UPI/000717871566/NA/Q44413441@ybl/Canara Bank     ,40,0,31359.81
332,07-01-2020,07-01-2020,-,UPI/000718328480/Oid202001071807/paytm-50765439@/P,105,0,31254.81
333,07-01-2020,07-01-2020,-,UPI/000720280513/NA/chakri.v@icici/ICICI Bank     ,700,0,30554.81
334,07-01-2020,07-01-2020,-,UPI/000720295045/UPI/prajgupta01@oki/ICICI Bank   ,80,0,30474.81
335,08-01-2020,08-01-2020,-,UPI/000814051344/UPI/aryan.singh2001/State Bank Of,1500,0,28974.81
336,08-01-2020,08-01-2020,-,UPI/000814103948/UPI/goog-payment@ok/Axis Bank Ltd,0,5,28979.81
337,09-01-2020,09-01-2020,-,VPS/AMAZON SELL/202001091153/000906616295/BANGALOR,1499,0,27480.81
338,10-01-2020,10-01-2020,-,UPI/001010975917/NA/Q28847431@ybl/City Union Bank ,20,0,27460.81
339,10-01-2020,10-01-2020,-,UPI/001016480047/Oid202001101658/pay9790847609@p/P,60,0,27400.81
340,10-01-2020,10-01-2020,-,UPI/001017013964/NA/8989990879@payt/State Bank Of ,0,350,27750.81
341,13-01-2020,13-01-2020,-,MABchgs-Dec19+GST                                 ,708,0,27042.81
342,11-01-2020,13-01-2020,-,UPI/001119023808/UPI/prajgupta01@oki/ICICI Bank   ,0,350,27392.81
343,11-01-2020,13-01-2020,-,UPI/001119374100/Oid202001111925/paytm-41887125@/P,25,0,27367.81
344,11-01-2020,13-01-2020,-,UPI/001123118665/NA/8989990879@payt/State Bank Of ,0,350,27717.81
345,12-01-2020,13-01-2020,-,IIN/Zaak Epayme/202001121518/001209083903/        ,45.62,0,27672.19
346,12-01-2020,13-01-2020,-,POSDEC CHG/19-12-2019/1685+GST                    ,29.5,0,27642.69
347,12-01-2020,13-01-2020,-,VPS/ENTERTAINME/202001121832/001213504352/BANGALOR,999,0,26643.69
348,13-01-2020,13-01-2020,-,UPI/001311699782/Oid202001131141/pay9940508458@p/P,35,0,26608.69
349,14-01-2020,14-01-2020,-,UPI/001409983711/Oid202001140943/paytm-40789937@/P,10,0,26598.69
350,14-01-2020,14-01-2020,-,UPI/001411386179/Oid202001141153/paytm-39036461@/P,40,0,26558.69
351,14-01-2020,14-01-2020,-,UPI/001411395792/Oid202001141154/paytm-39036461@/P,5,0,26553.69
352,14-01-2020,14-01-2020,-,UPI/001416185206/Oid202001141602/paytm-42329413@/P,40,0,26513.69
353,15-01-2020,15-01-2020,-,NFS/P1ENCN16/CASH WDL/15-01-20                    ,800,0,25713.69
354,17-01-2020,17-01-2020,-,UPI/001718312835/Oid202001171811/paytm-9326077@p/P,20,0,25693.69
355,17-01-2020,17-01-2020,-,UPI/001718650968/Oid202001171832/pay9940508458@p/P,30,0,25663.69
356,17-01-2020,17-01-2020,-,VPS/TAJ MAHAL R/202001172032/001715007114/KANCHEEP,440,0,25223.69
357,17-01-2020,17-01-2020,-,UPI/001720298846/Friends/chakri.v@icici/ICICI Bank,0,140,25363.69
358,18-01-2020,18-01-2020,-,UPI/001813242304/Oid202001181329/paytm-709790@pa/P,80,0,25283.69
359,18-01-2020,18-01-2020,-,IIN/Zomato     /202001181957/001814417179/        ,143.55,0,25140.14
360,19-01-2020,20-01-2020,-,BIL/INFT/001899497208/                            ,0,1500,26640.14
361,19-01-2020,20-01-2020,-,UPI/001920392442/UPI/faasos@axisbank/Axis Bank Ltd,315,0,26325.14
362,19-01-2020,20-01-2020,-,UPI/001920474881/UPI/goog-payment@ok/Axis Bank Ltd,0,6,26331.14
363,21-01-2020,21-01-2020,-,UPI/002113233558/NA/Q28847431@ybl/City Union Bank ,50,0,26281.14
364,21-01-2020,21-01-2020,-,UPI/002116877265/NA/Q28847431@ybl/City Union Bank ,22,0,26259.14
365,22-01-2020,22-01-2020,-,UPI/002210742314/NA/Q28847431@ybl/City Union Bank ,50,0,26209.14
366,22-01-2020,22-01-2020,-,UPI/002213652435/NA/Q34896424@ybl/Vijaya Bank     ,30,0,26179.14
367,22-01-2020,22-01-2020,-,UPI/002221738894/NA/Q24380470@ybl/Axis Bank Ltd.  ,110,0,26069.14
368,22-01-2020,22-01-2020,-,UPI/002222336284/NA/chakri.v@icici/ICICI Bank     ,55,0,26014.14
369,23-01-2020,23-01-2020,-,UPI/002315542503/NA/9080868614@okbi/Axis Bank Ltd.,90,0,25924.14
370,23-01-2020,23-01-2020,-,UPI/002320240530/UPI/faasos@axisbank/Axis Bank Ltd,121,0,25803.14
371,24-01-2020,24-01-2020,-,UPI/002411993422/Oid202001241149/paytm-709790@pa/P,50,0,25753.14
372,24-01-2020,24-01-2020,-,UPI/002411007921/Oid202001241150/paytm-709790@pa/P,60,0,25693.14
373,24-01-2020,24-01-2020,-,VPS/TABLE 9 BLE/202001242127/002415147324/KANCHEEP,220,0,25473.14
374,25-01-2020,27-01-2020,-,VIN/Bigtree Ent/202001250754/002513334033/        ,194.34,0,25278.8
375,25-01-2020,27-01-2020,-,VPS/SUBWAY     /202001251327/002507310443/KANCHIPU,140,0,25138.8
376,25-01-2020,27-01-2020,-,UPI/002522012484/NA/chakri.v@icici/ICICI Bank     ,130,0,25008.8
377,26-01-2020,27-01-2020,-,BIL/INFT/001904430487/NA/                         ,0,5000,30008.8
378,26-01-2020,27-01-2020,-,IIN/Zaak Epayme/202001261510/002609696451/        ,51.24,0,29957.56
379,26-01-2020,27-01-2020,-,VPS/JAZZ CINEMA/202001261532/002610255767/CHENNAI ,40,0,29917.56
380,26-01-2020,27-01-2020,-,IIN/Zaak Epayme/202001261859/002613309285/        ,45.5,0,29872.06
381,26-01-2020,27-01-2020,-,UPI/002619130534/NA/9712806962@payt/ICICI Bank    ,1,0,29871.06
382,26-01-2020,27-01-2020,-,UPI/002619137622/NA/9712806962@payt/ICICI Bank    ,499,0,29372.06
383,27-01-2020,27-01-2020,-,UPI/002715634484/NA/Q28847431@ybl/City Union Bank ,40,0,29332.06
384,27-01-2020,27-01-2020,-,UPI/002720134550/Verified Mercha/BHARATPE.904081/I,135,0,29197.06
385,28-01-2020,28-01-2020,-,UPI/002815274996/NA/8460706112@payt/ICICI Bank    ,0,40,29237.06
386,29-01-2020,29-01-2020,-,UPI/002909389610/Oid202001290916/paytm-40789937@/P,15,0,29222.06
387,29-01-2020,29-01-2020,-,UPI/002911813543/Oid202001291139/paytm-40789937@/P,50,0,29172.06
388,29-01-2020,29-01-2020,-,UPI/002929041321/NA/9744457231@ybl/Vijaya Bank    ,110,0,29062.06
389,30-01-2020,30-01-2020,-,UPI/003038746347/Oid202001301132/paytm-709790@pa/P,130,0,28932.06
390,31-01-2020,31-01-2020,-,UPI/003149410040/NA/Q28847431@ybl/City Union Bank ,58,0,28874.06
391,31-01-2020,31-01-2020,-,UPI/003155514651/NA/8989990879@payt/State Bank Of ,85,0,28789.06
392,31-01-2020,31-01-2020,-,UPI/003157833875/Payment made to/o718215b@mairte/A,40,0,28749.06
393,01-02-2020,01-02-2020,-,UPI/003264881298/Oid202002011411/paytm-14750770@/P,45,0,28704.06
394,01-02-2020,01-02-2020,-,UPI/003264972403/Oid202002011418/paytm-14781806@/P,75,0,28629.06
395,01-02-2020,01-02-2020,-,UPI/003269907385/NA/AMZN0000258860@/Kerala Gramin ,95,0,28534.06
396,01-02-2020,01-02-2020,-,UPI/003270142421/NA/AMZN0000258860@/Kerala Gramin ,40,0,28494.06
397,02-02-2020,03-02-2020,-,NFS/00824012/CASH WDL/02-02-20                    ,500,0,27994.06
398,02-02-2020,03-02-2020,-,UPI/003321194457/NA/chakri.v@icici/ICICI Bank     ,300,0,27694.06
399,02-02-2020,03-02-2020,-,UPI/003384195887/Oid202002022143/pay9894543033@p/P,25,0,27669.06
400,03-02-2020,03-02-2020,-,UPI/003493004378/NA/9080868614@okbi/Axis Bank Ltd.,90,0,27579.06
401,03-02-2020,03-02-2020,-,UPI/003493514709/Promo Cashback/upi-cashback@pa/Pa,0,5,27584.06
402,03-02-2020,03-02-2020,-,UPI/003498326835/NA/9712806962@payt/ICICI Bank    ,500,0,27084.06
403,03-02-2020,03-02-2020,-,UPI/003422031345/Friends/chakri.v@icici/ICICI Bank,0,400,27484.06
404,03-02-2020,03-02-2020,-,UPI/003422037042/Friends/chakri.v@icici/ICICI Bank,0,100,27584.06
405,04-02-2020,04-02-2020,-,UPI/003502627299/Oid202002041132/pay9940508458@p/P,30,0,27554.06
406,04-02-2020,04-02-2020,-,UPI/003510358612/NA/Q34896424@ybl/Vijaya Bank     ,45,0,27509.06
407,05-02-2020,05-02-2020,-,UPI/003616041466/NA/Q28847431@ybl/City Union Bank ,18,0,27491.06
408,05-02-2020,05-02-2020,-,UPI/003616156054/NA/Q28847431@ybl/City Union Bank ,50,0,27441.06
409,05-02-2020,05-02-2020,-,UPI/003616945397/Oid202002051213/pay9940508458@p/P,30,0,27411.06
410,05-02-2020,05-02-2020,-,UPI/003620472250/Oid202002051651/paytm-5262118@p/P,20,0,27391.06
411,06-02-2020,06-02-2020,-,UPI/003730008366/Payment made to/o331289a@mairte/A,50,0,27341.06
412,06-02-2020,06-02-2020,-,UPI/003730037545/Payment made to/o331289a@mairte/A,10,0,27331.06
413,06-02-2020,06-02-2020,-,UPI/003734138966/Oid202002061646/pay9940508458@p/P,30,0,27301.06
414,07-02-2020,07-02-2020,-,UPI/003842342580/NA/Q28847431@ybl/City Union Bank ,20,0,27281.06
415,07-02-2020,07-02-2020,-,UPI/003847310745/NA/AMZN0000989852@/Bandhan Bank  ,110,0,27171.06
416,07-02-2020,07-02-2020,-,UPI/003847318267/NA/8758389877@payt/ICICI Bank    ,140,0,27031.06
417,07-02-2020,07-02-2020,-,UPI/003847411013/Oid202002071603/pay9940508458@p/P,30,0,27001.06
418,08-02-2020,10-02-2020,-,UPI/003959708416/Oid202002081354/paytm-41887125@/P,50,0,26951.06
419,08-02-2020,10-02-2020,-,UPI/003959326080/Oid202002081327/paytm-39036461@/P,90,0,26861.06
420,08-02-2020,10-02-2020,-,UPI/003961594784/Oid202002081636/pay9940508458@p/P,30,0,26831.06
421,08-02-2020,10-02-2020,-,UPI/003961676912/Payment made to/o331289a@mairte/A,164,0,26667.06
422,08-02-2020,10-02-2020,-,UPI/003940658789/Payment from Ph/OVENSTORYINAPP@/Y,594,0,26073.06
423,09-02-2020,10-02-2020,-,UPI/004072622030/Oid202002091346/pay9940508458@p/P,30,0,26043.06
424,09-02-2020,10-02-2020,-,UPI/004077802320/Oid202002092025/paytm-30477057@/P,100,0,25943.06
425,10-02-2020,10-02-2020,-,UPI/004188131796/NA/8989990879@payt/State Bank Of ,0,100,26043.06
426,10-02-2020,10-02-2020,-,UPI/004188274071/Oid202002101740/pay9940508458@p/P,30,0,26013.06
427,10-02-2020,10-02-2020,-,UPI/004188376799/NA/8989990879@payt/State Bank Of ,95,0,25918.06
428,10-02-2020,10-02-2020,-,UPI/004188947212/Promo Cashback/upi-cashback@pa/Pa,0,5,25923.06
429,10-02-2020,10-02-2020,-,UPI/004191931257/Verified Mercha/BHARATPE.904081/I,10,0,25913.06
430,11-02-2020,11-02-2020,-,UPI/004296153479/NA/Q34896424@ybl/Vijaya Bank     ,60,0,25853.06
431,11-02-2020,11-02-2020,-,UPI/004201078253/NA/Q28847431@ybl/City Union Bank ,25,0,25828.06
432,11-02-2020,11-02-2020,-,UPI/004202132265/NA/9712806962@payt/ICICI Bank    ,25,0,25803.06
433,12-02-2020,12-02-2020,-,MABchgs-Jan20+GST                                 ,155.11,0,25647.95
434,14-02-2020,14-02-2020,-,UPI/004509161954/Friends/surajsherwood@i/ICICI Ban,0,15,25662.95
435,14-02-2020,14-02-2020,-,ATM/SACWF854/CASH WDL/14-02-20                    ,200,0,25462.95
436,14-02-2020,14-02-2020,-,BIL/INFT/001921801978/                            ,0,3000,28462.95
437,15-02-2020,15-02-2020,-,UPI/004609406924/Friends/surajsherwood@i/ICICI Ban,0,320,28782.95
438,15-02-2020,15-02-2020,-,VPS/DOMINOS    /202002151321/004607991741/CHENNAI ,61.96,0,28720.99
439,15-02-2020,15-02-2020,-,VPS/VENTOTA RET/202002151626/004610158574/CHENNAI ,100,0,28620.99
440,15-02-2020,15-02-2020,-,VPS/STARMARK   /202002151655/004611184246/CHENNAI ,125,0,28495.99
441,15-02-2020,15-02-2020,-,VPS/TATA STARBU/202002151751/004612237250/CHENNAI ,200,0,28295.99
442,15-02-2020,15-02-2020,-,NFS/00824012/CASH WDL/15-02-20                    ,1000,0,27295.99
443,15-02-2020,15-02-2020,-,UPI/004620177643/UPI/kuttynirmal9085/Canara Bank  ,0,200,27495.99
444,16-02-2020,17-02-2020,-,UPI/004708411112/NA/balagrandhi@ici/ICICI Bank    ,2000,0,25495.99
445,16-02-2020,17-02-2020,-,UPI/004772733109/NA/SUBWAY.44045772/HDFC BANK LTD ,140,0,25355.99
446,16-02-2020,17-02-2020,-,UPI/004772925630/Oid202002161919/pay9895962010@p/P,50,0,25305.99
447,16-02-2020,17-02-2020,-,UPI/004720236148/payU/thecollegefever/Axis Bank Lt,550,0,24755.99
448,16-02-2020,17-02-2020,-,BIL/INFT/001923203578/MIB-/                       ,0,2000,26755.99
449,17-02-2020,17-02-2020,-,UPI/004885117593/Payment made to/o331289a@mairte/A,10,0,26745.99
450,17-02-2020,17-02-2020,-,UPI/004885130407/Payment made to/o331289a@mairte/A,10,0,26735.99
451,17-02-2020,17-02-2020,-,UPI/004886821322/NA/9712806962@payt/ICICI Bank    ,320,0,26415.99
452,17-02-2020,17-02-2020,-,UPI/004887296257/Oid202002172,170,0,26245.99
453,18-02-2020,18-02-2020,-,UPI/004918817203/On tapping Pay/paytmqr28100505/Pa,70,0,26175.99
454,18-02-2020,18-02-2020,-,UPI/004995917066/NA/Q28847431@ybl/City Union Bank ,10,0,26165.99
455,18-02-2020,18-02-2020,-,UPI/004995957761/NA/Q28847431@ybl/City Union Bank ,10,0,26155.99
460,19-02-2020,19-02-2020,-,UPI/005014118422/NA/AMZN0000258662@/HDFC BANK LTD ,80,0,1235.4
461,19-02-2020,19-02-2020,-,UPI/005014457629/NA/Chakravarti Vis/Paytm Payments,46,0,1189.4
462,20-02-2020,20-02-2020,-,UPI/005119535813/NA/Q67437556@ybl/Yes Bank Ltd    ,105,0,1084.4
463,20-02-2020,20-02-2020,-,UPI/005119808906/NA/Q67437556@ybl/Yes Bank Ltd    ,70,0,1014.4
464,20-02-2020,20-02-2020,-,UPI/005111215697/UPI/payelpaulrose@o/State Bank Of,0,55,1069.4
465,20-02-2020,20-02-2020,-,UPI/005125038542/Oid202002201833/paytm-709790@pa/P,50,0,1019.4
466,21-02-2020,21-02-2020,-,UPI/005235941607/Oid202002211553/pay9940508458@p/P,20,0,999.4
467,23-02-2020,24-02-2020,-,UPI/005458614895/Oid202002231250/paytm-39036461@/P,55,0,944.4
468,23-02-2020,24-02-2020,-,UPI/005458659457/Oid202002231254/pay9895962010@p/P,20,0,924.4
469,23-02-2020,24-02-2020,-,UPI/005458958085/Oid202002231319/paytm-39036461@/P,40,0,884.4
470,23-02-2020,24-02-2020,-,UPI/005461559593/Oid202002231718/paytm-25919725@/P,30,0,854.4
471,23-02-2020,24-02-2020,-,UPI/005461659656/Oid202002231727/pay9940508458@p/P,30,0,824.4
472,23-02-2020,24-02-2020,-,UPI/005476858143/Payment from Ph/OVENSTORYINAPP@/Y,445,0,379.4
473,25-02-2020,25-02-2020,-,UPI/005615376949/Friends/surajsherwood@i/ICICI Ban,0,60,439.4
474,25-02-2020,25-02-2020,-,UPI/005686220495/NA/Q67437556@ybl/Yes Bank Ltd    ,60,0,379.4
475,25-02-2020,25-02-2020,-,UPI/005686773802/NA/9712806962@payt/ICICI Bank    ,210,0,169.4
476,25-02-2020,25-02-2020,-,UPI/005686910555/NA/8989990879@payt/State Bank Of ,0,200,369.4
477,25-02-2020,25-02-2020,-,UPI/005688579455/NA/Suraj Srm Cse B/Paytm Payments,30,0,339.4
478,26-02-2020,26-02-2020,-,BIL/INFT/001929527681/                            ,0,5000,5339.4
479,26-02-2020,26-02-2020,-,UPI/005794667222/Oid202002261036/paytm-40789937@/P,25,0,5314.4
480,26-02-2020,26-02-2020,-,UPI/005799278459/Oid202002261651/paytm-29472@pay/P,35,0,5279.4
481,26-02-2020,26-02-2020,-,UPI/005799743837/NA/9080868614@okbi/Axis Bank Ltd.,60,0,5219.4
482,26-02-2020,26-02-2020,-,UPI/005701836009/NA/SUBWAY.44045772/HDFC BANK LTD ,90,0,5129.4
483,27-02-2020,27-02-2020,-,UPI/005810492282/NA/Q28181322@ybl/City Union Bank ,15,0,5114.4
484,27-02-2020,27-02-2020,-,UPI/005857488931/Payment from Ph/FIRANGIBAKEINAP/Y,88,0,5026.4
485,28-02-2020,28-02-2020,-,UPI/005919989130/NA/Q28847431@ybl/City Union Bank ,30,0,4996.4
486,28-02-2020,28-02-2020,-,UPI/005925099004/Oid202002281626/paytm-39889673@/P,333,0,4663.4
487,28-02-2020,28-02-2020,-,UPI/005916360512/Friends/chakri.v@icici/ICICI Bank,0,20,4683.4
488,28-02-2020,28-02-2020,-,UPI/005925127022/Oid202002281629/pay8056184728@p/P,40,0,4643.4
489,28-02-2020,28-02-2020,-,UPI/005927871494/NA/8758389877@payt/ICICI Bank    ,126,0,4517.4
490,28-02-2020,28-02-2020,-,UPI/005980857480/Payment from ,174,0,4343.4
491,29-02-2020,29-02-2020,-,UPI/006036563184/Oid202002291345/paytm-39036461@/P,9,0,4334.4
492,29-02-2020,29-02-2020,-,UPI/006013002972/NA/chakri.v@icici/ICICI Bank     ,70,0,4264.4
493,29-02-2020,29-02-2020,-,UPI/006041217579/NA/8758389877@payt/ICICI Bank    ,20,0,4244.4
494,29-02-2020,29-02-2020,-,UPI/006042326960/Oid202002292018/paytm-18597310@/P,105,0,4139.4
495,29-02-2020,29-02-2020,-,UPI/006021267849/Wallet Topup/FXM@ybl/Yes Bank Ltd,1,0,4138.4
496,29-02-2020,29-02-2020,-,UPI/006021168660/Oid743102474UPI/food-paytm@icic/I,104,0,4034.4
497,01-03-2020,02-03-2020,-,UPI/006147215303/NA/Q05540747@ybl/Axis Bank Ltd.  ,15,0,4019.4
498,01-03-2020,02-03-2020,-,UPI/006147334164/NA/Q05540747@ybl/Axis Bank Ltd.  ,10,0,4009.4
499,01-03-2020,02-03-2020,-,UPI/006154322068/Oid202003011850/pay9952034054@p/P,120,0,3889.4
500,01-03-2020,02-03-2020,-,UPI/006118352609/Friends/chakri.v@icici/ICICI Bank,0,100,3989.4
501,01-03-2020,02-03-2020,-,UPI/006155270376/Oid202003011937/paytm-14662082@/P,50,0,3939.4
502,01-03-2020,02-03-2020,-,UPI/006155493688/Oid202003011951/pay9940508458@p/P,30,0,3909.4
503,02-03-2020,02-03-2020,-,UPI/006200168813/Friends/chakri.v@icici/ICICI Bank,0,60,3969.4
504,02-03-2020,02-03-2020,-,UPI/006264619533/NA/8989990879@payt/State Bank Of ,20,0,3949.4
505,02-03-2020,02-03-2020,-,UPI/006265391263/Oid202003021510/paytm-40789937@/P,20,0,3929.4
506,02-03-2020,02-03-2020,-,UPI/006266018126/Oid202003021601/paytm-40789937@/P,55,0,3874.4
507,03-03-2020,03-03-2020,-,UPI/006379888814/Oid202003031431/paytm-40789937@/P,30,0,3844.4
508,03-03-2020,03-03-2020,-,UPI/006383156050/Oid202003031822/paytm-41846893@/P,170,0,3674.4
509,03-03-2020,03-03-2020,-,UPI/006383285937/NA/Q40650663@ybl/Paytm Payments  ,316,0,3358.4
510,03-03-2020,03-03-2020,-,UPI/006383338630/NA/Q10149530@ybl/IDFC FIRST Bank ,30,0,3328.4
511,03-03-2020,03-03-2020,-,UPI/006385933137/Verified Mercha/BHARATPE.904081/I,20,0,3308.4
512,03-03-2020,03-03-2020,-,UPI/006320316730/Friends/chakri.v@icici/ICICI Bank,0,20,3328.4
513,03-03-2020,03-03-2020,-,UPI/006320354545/NA/chakri.v@icici/ICICI Bank     ,1030,0,2298.4
514,03-03-2020,03-03-2020,-,UPI/006321362577/Friends/chakri.v@icici/ICICI Bank,0,200,2498.4
515,03-03-2020,03-03-2020,-,UPI/006321392636/Friends/chakri.v@icici/ICICI Bank,0,1.6,2500
516,04-03-2020,04-03-2020,-,UPI/006492351288/Oid202003041156/paytm-709790@pa/P,50,0,2450
517,04-03-2020,04-03-2020,-,UPI/006492543951/Oid202003041210/pay9940508458@p/P,30,0,2420
518,05-03-2020,05-03-2020,-,UPI/006508998675/Oid202003051341/paytm-40275929@/P,20,0,2400
519,06-03-2020,06-03-2020,-,UPI/006621182963/NA/abhudaym@paytm/State Bank Of I,30,0,2370
520,06-03-2020,06-03-2020,-,UPI/006621985204/NA/9901085132@payt/DBS Bank India,250,0,2120
521,06-03-2020,06-03-2020,-,UPI/006631606863/Oid202003062152/paytm-38583141@/P,40,0,2080
522,06-03-2020,06-03-2020,-,UPI/006631762512/Oid202003062203/paytm-38583141@/P,40,0,2040
523,07-03-2020,07-03-2020,-,UPI/006741648372/NA/8989990879@payt/State Bank Of ,50,0,1990
524,07-03-2020,07-03-2020,-,UPI/006741849943/Oid202003071746/paytm-9326077@p/P,20,0,1970
525,07-03-2020,07-03-2020,-,UPI/006742121952/NA/shreyansgalada@/South Indian B,100,0,1870
526,07-03-2020,07-03-2020,-,UPI/006746984846/NA/8989990879@payt/State Bank Of ,400,0,1470
527,07-03-2020,07-03-2020,-,UPI/006747048700/NA/7418545826@payt/Paytm Payments,15,0,1455
528,08-03-2020,09-03-2020,-,UPI/006851807590/NA/abhudaym@paytm/State Bank Of I,0,100,1555
529,08-03-2020,09-03-2020,-,UPI/006851817261/NA/abhudaym@paytm/State Bank Of I,100,0,1455
530,08-03-2020,09-03-2020,-,UPI/006852265403/Promo Cashback/upi-cashback@pa/Pa,0,5,1460
531,08-03-2020,09-03-2020,-,UPI/006852883570/Oid202003081355/paytm-33406257@/P,200,0,1260
532,08-03-2020,09-03-2020,-,UPI/006854256482/NA/9849977964@payt/Paytm Payments,80,0,1180
533,08-03-2020,09-03-2020,-,UPI/006854344921/Oid202003081559/paytm-33406257@/P,110,0,1070
534,08-03-2020,09-03-2020,-,UPI/006816206256/NA/9594969828@payt/              ,120,0,950
535,08-03-2020,09-03-2020,-,UPI/006855227185/NA/abhudaym@paytm/State Bank Of I,20,0,930
536,08-03-2020,09-03-2020,-,UPI/006855675005/NA/abhudaym@paytm/State Bank Of I,60,0,870
537,08-03-2020,09-03-2020,-,UPI/006858458940/NA/arunsinghvi8502/IDBI Bank Limi,100,0,770
538,08-03-2020,09-03-2020,-,UPI/006858967494/NA/Q83678201@ybl/ICICI Bank      ,150,0,620
539,08-03-2020,09-03-2020,-,UPI/006859202281/Oid202003082117/paytm-38583141@/P,40,0,580
540,09-03-2020,09-03-2020,-,UPI/006917546235/Payment from Ph/9123580564@payt/P,70,0,510
541,09-03-2020,09-03-2020,-,UPI/006976023067/On tapping Pay/o331289a@mairte/Ai,20,0,490
542,10-03-2020,10-03-2020,-,UPI/007080292881/Oid202003101551/pay8939008700@p/P,30,0,460
543,10-03-2020,10-03-2020,-,UPI/007020223516/NA/chakri.v@icici/ICICI Bank     ,200,0,260
544,11-03-2020,11-03-2020,-,UPI/007187660815/NA/Q28847431@ybl/City Union Bank ,10,0,250
545,11-03-2020,11-03-2020,-,UPI/007193148680/Oid202003111657/pay9940508458@p/P,30,0,220
546,11-03-2020,11-03-2020,-,BIL/INFT/001943897245/NA/                         ,0,3000,3220
547,11-03-2020,11-03-2020,-,UPI/007195079576/Oid202003111901/pay9940508458@p/P,30,0,3190
548,12-03-2020,12-03-2020,-,UPI/007202491679/Oid202003121135/paytm-709790@pa/P,80,0,3110
549,12-03-2020,12-03-2020,-,UPI/007202581354/Oid202003121142/paytm-709790@pa/P,80,0,3030
550,12-03-2020,12-03-2020,-,UPI/007202586806/Oid202003121142/paytm-709790@pa/P,10,0,3020
551,12-03-2020,12-03-2020,-,UPI/007202604754/Oid202003121144/pay9677057223@p/P,10,0,3010
552,13-03-2020,13-03-2020,-,UPI/007315412348/Oid202003131046/paytm-40789937@/P,20,0,2990
553,13-03-2020,13-03-2020,-,UPI/007324554002/NA/8758389877@payt/ICICI Bank    ,45,0,2945
554,13-03-2020,13-03-2020,-,UPI/007324562687/NA/abhudaym@paytm/State Bank Of I,10,0,2935
555,13-03-2020,13-03-2020,-,UPI/007324687761/Oid202003132126/pay9940508458@p/P,35,0,2900
556,14-03-2020,16-03-2020,-,UPI/007431160491/Oid202003141343/paytm-30477057@/P,150,0,2750
557,14-03-2020,16-03-2020,-,UPI/007431960456/Oid202003141447/pay9940508458@p/P,30,0,2720
558,14-03-2020,16-03-2020,-,UPI/007432059865/Oid202003141455/paytm-30963249@/P,110,0,2610
559,14-03-2020,16-03-2020,-,UPI/007435462687/NA/abhudaym@paytm/State Bank Of I,0,75,2685
560,14-03-2020,16-03-2020,-,UPI/007437230600/Oid202003142056/pay6381493452@p/P,140,0,2545
561,14-03-2020,16-03-2020,-,UPI/007437402231/Oid202003142106/pay9941665870@p/P,360,0,2185
562,14-03-2020,16-03-2020,-,UPI/007437498790/Oid202003142112/paytm-39889673@/P,100,0,2085
563,14-03-2020,16-03-2020,-,UPI/007437548466/Oid202003142115/paytm-39889673@/P,107,0,1978
564,15-03-2020,16-03-2020,-,UPI/007516385997/Friends/chakri.v@icici/ICICI Bank,0,65,2043
565,15-03-2020,16-03-2020,-,UPI/007545879595/Oid202003151647/paytm-39036461@/P,15,0,2028
566,15-03-2020,16-03-2020,-,UPI/007545886599/NA/Q97706911@ybl/Axis Bank Ltd.  ,10,0,2018
567,15-03-2020,16-03-2020,-,BIL/INFT/001947039442/NA/                         ,0,15000,17018
568,15-03-2020,16-03-2020,-,IIN/Flipkart Pa/202003152233/007517523051/        ,6911,0,10107
569,16-03-2020,16-03-2020,-,UPI/007651854379/NA/8989990879@payt/State Bank Of ,130,0,9977
570,16-03-2020,16-03-2020,-,UPI/007656998566/Oid202003161414/paytm-29472@pay/P,35,0,9942
571,16-03-2020,16-03-2020,-,UPI/007657202534/Oid202003161430/pay9941665870@p/P,93,0,9849
572,16-03-2020,16-03-2020,-,UPI/007657256156/Oid202003161435/pay9941665870@p/P,300,0,9549
573,16-03-2020,16-03-2020,-,UPI/007657466811/Oid202003161452/paytm-39889673@/P,20,0,9529
574,16-03-2020,16-03-2020,-,UPI/007660707549/Oid202003161900/pay9551609666@p/P,90,0,9439
575,16-03-2020,16-03-2020,-,UPI/007662353054/NA/8989990879@payt/State Bank Of ,0,230,9669
576,16-03-2020,16-03-2020,-,UPI/007662741029/Oid746213775UPI/dominospizzaonl/P,690,0,8979
577,16-03-2020,16-03-2020,-,NFS/00824013/CASH WDL/16-03-20                    ,700,0,8279
578,17-03-2020,17-03-2020,-,VPS/TRAVEL FOOD/202003170425/007722189027/CHENNAI ,2,0,8277
579,17-03-2020,17-03-2020,-,VPS/TRAVEL CLUB/202003170527/007723193828/CHENNAI ,1310,0,6967
580,17-03-2020,17-03-2020,-,MABchgs-Feb20+GST                                 ,388.8,0,6578.2
581,20-03-2020,20-03-2020,-,BIL/INFT/001950126761/NA/                         ,0,25000,31578.2
582,20-03-2020,20-03-2020,-,UPI/008013239007/Oid746824560UPI/dominospizzaonl/P,523,0,31055.2
583,29-03-2020,30-03-2020,-,418401503466:Int.Pd:31-12-2019 to 29-03-2020      ,0,166,31221.2
584,11-04-2020,13-04-2020,-,UPI/010211349505/NA/chakri.v@icici/ICICI Bank     ,25,0,31196.2
585,11-05-2020,11-05-2020,-,UPI/013211237702/NA/chakri.v@icici/ICICI Bank     ,25,0,31171.2
586,04-06-2020,04-06-2020,-,UPI/015640605060/NA/Q11456702@ybl/State Bank Of I ,180,0,30991.2
587,11-06-2020,11-06-2020,-,UPI/016312229654/NA/chakri.v@icici/ICICI Bank     ,25,0,30966.2
588,17-06-2020,17-06-2020,-,UPI/016936447588/Payment from Ph/9229559499@ybl/Pu,0,20,30986.2
589,17-06-2020,17-06-2020,-,UPI/016912170719/UPI/vaibhavsharma31/HDFC BANK LTD,20,0,30966.2
590,20-06-2020,20-06-2020,-,IIN/I-Debit/Amazon     /202006201847/017210014162/,2247,0,28719.2
591,20-06-2020,20-06-2020,-,UPI/017218263279/UPI/prajgupta01@oki/ICICI Bank   ,0,450,29169.2
592,20-06-2020,20-06-2020,-,UPI/017207390899/Chakri gift con/aniket.sk@paytm/S,0,449,29618.2
593,21-06-2020,22-06-2020,-,UPI/017316270292/NA/abhudaym@paytm/State Bank Of I,0,449,30067.2
594,29-06-2020,29-06-2020,-,DCardfee1685JUN20-MAY21+GST                       ,588.82,0,29478.38
595,28-06-2020,29-06-2020,-,418401503466:Int.Pd:30-03-2020 to 28-06-2020      ,0,248,29726.38
596,30-06-2020,30-06-2020,-,UPI/018211141050/Chakri bday gif/7003739133@payt/I,0,449,30175.38
597,02-07-2020,02-07-2020,-,UPI/018488390890/Payment from Ph/6290922428@ybl/St,0,20,30195.38
598,02-07-2020,02-07-2020,-,UPI/018423408613/UPI/vaibhavsharma31/HDFC BANK LTD,20,0,30175.38
